###############################
#     #                 #     #
##### ############### ### ### #
#   #               #       # #
### ############### ######### #
#   #             #   #       #
# ### # # ########### # ##### #
#     # # #     #     #     # #
# ##### # # ### # ##### ### ###
# # #   # # # # # #     # #   #
# # # # ### # # # # ##### ### #
#   # # #   # #   #       #   #
### # ### ### ############# # #
#   #   # #                 # #
# ##### # # ####### ##### #####
#     #   # #     # # #   #   #
##### ####### ### # # # ### # #
#   # #     # #   # #     # # #
# ### # ### # ### # # ##### # #
# #   # #   #   # # # #     # #
# # ### # ##### # # ### ##### #
#   #   #       # #     #   # #
# ### ########### ### ### # # #
#   # #       # #   # #   # # #
### # # ### # # ### ### ### # #
#   # # # # #   #   #   # #   #
# ### # # # ##### ### ### ### #
# #   # # # #     #   #     # #
# # ### # # # ##### ### # ### #
#   #     #         #   #     #
###############################